243 243 243 243 243 243 243 243 176 176 176 176 176 243 243 243 243 176 176 176 176 176 176 176 243 243 243 243 243 243 243 243 243 176 176 176 176 176 176 176 176 176 176 176 192 192 176 176 176 176 176 176 243 243 243 243 243 243 243 243 243 176 176 176 243 243 243 243 243 243 243 243 243 243 243 176 176 176 176 176 176 176 243 243 243 243 243 243 176 176 176 176 176 176 176 176 243 243 243 243
243 243 243 243 176 176 176 176 176 176 176 176 176 176 176 176 176 176 176 176 176 176 176 176 176 176 243 243 243 243 243 243 176 176 176 176 176 176 176 176 192 192 192 192 208 208 192 192 192 176 176 176 176 176 176 176 176 243 243 243 176 176 176 176 176 243 243 243 176 176 176 243 243 176 176 176 176 176 176 192 176 176 176 176 176 176 243 176 176 176 176 176 192 192 176 176 176 176 243 243
243 243 176 176 176 176 176 176 176 176 176 176 176 176 176 176 176 176 176 176 176 176 176 176 176 176 176 176 176 243 176 176 176 176 176 192 192 192 192 192 208 208 208 208 208 208 208 208 208 192 192 176 176 176 192 192 192 176 176 176 176 176 176 176 176 176 243 176 176 192 176 176 176 176 176 192 192 192 192 208 192 192 192 192 176 176 176 176 176 192 192 192 208 208 208 192 176 176 243 243
243 176 176 176 176 176 176 176 176 176 176 176 176 176 176 176 176 176 176 176 176 176 176 176 176 176 176 176 176 176 176 176 176 192 192 208 208 208 208 208 208 208 208 208 208 208 208 208 208 208 208 192 192 192 208 208 208 192 192 192 176 176 176 176 176 176 176 176 192 208 192 054 192 192 192 208 208 208 208 208 208 208 208 208 192 192 192 192 192 208 208 208 208 208 208 208 192 192 176 243
176 176 054 176 176 176 176 192 192 192 192 176 176 176 176 176 192 192 176 176 192 192 192 192 192 176 176 176 176 176 176 192 192 208 208 208 208 208 208 208 208 208 208 208 208 208 208 208 208 208 208 208 208 208 208 208 208 208 208 208 192 192 192 192 192 192 192 192 102 208 208 070 208 208 208 208 208 208 208 208 208 208 208 208 208 208 208 208 208 208 208 208 208 208 208 208 208 208 192 192
118 176 070 176 192 192 192 208 208 208 208 192 192 192 192 192 208 208 192 192 208 208 208 208 208 192 192 192 192 192 192 208 208 208 208 208 208 208 208 208 208 208 208 208 208 224 224 224 208 208 208 208 208 208 208 208 208 208 208 208 208 208 208 208 118 006 006 007 023 007 022 086 208 208 056 208 208 208 208 208 208 208 208 208 208 208 208 208 208 208 208 208 208 208 208 208 208 208 208 208
023 006 086 192 056 208 208 208 208 208 208 208 208 208 208 208 208 208 208 208 208 208 208 208 208 208 208 208 208 208 208 208 208 208 208 208 208 208 208 208 208 208 224 224 224 240 240 240 224 224 224 224 208 208 208 055 055 055 055 055 208 208 208 208 023 022 039 038 008 008 038 006 007 023 006 023 208 208 208 208 055 033 055 032 033 208 208 208 208 208 208 208 208 208 208 208 208 208 208 224
008 024 006 007 023 128 208 208 208 208 208 208 208 208 208 208 208 208 208 208 208 208 208 208 208 208 208 135 208 208 208 208 208 208 208 054 208 208 208 224 224 224 240 240 240 240 240 240 118 240 240 240 224 055 055 055 055 208 208 208 208 208 208 208 022 022 022 008 008 022 022 022 022 022 022 022 008 224 208 208 208 055 208 208 208 208 208 208 208 208 208 208 208 208 208 208 224 224 224 240
022 008 039 024 024 006 007 208 208 208 208 208 208 208 208 208 208 208 208 208 208 128 208 208 208 208 208 006 023 006 118 208 208 224 224 070 224 056 224 240 240 240 240 240 007 023 023 007 022 023 240 240 240 224 224 224 224 224 208 208 208 208 208 224 038 022 008 039 022 022 008 038 022 022 040 008 039 128 224 208 208 208 208 208 208 208 208 208 208 055 032 055 055 224 224 224 240 240 240 240
038 022 022 024 022 022 008 224 224 208 208 208 208 224 224 224 224 224 224 208 208 055 025 026 027 055 055 022 039 039 023 006 007 240 240 086 240 007 006 240 128 240 240 240 240 008 039 022 039 039 240 240 240 240 240 240 240 240 224 224 224 224 224 240 240 022 022 038 024 040 024 024 008 040 039 022 022 038 240 224 224 224 224 224 208 208 208 208 055 055 208 224 224 240 240 240 240 240 058 240
040 024 038 040 024 022 038 240 240 224 224 224 224 240 240 240 240 240 240 224 224 224 224 224 240 240 240 022 024 039 024 024 024 023 006 006 023 022 022 007 006 240 240 240 240 240 240 022 038 022 022 240 240 240 240 240 240 240 240 240 240 240 240 240 240 022 022 022 039 022 039 008 039 038 038 022 022 022 240 240 240 240 240 240 224 224 224 224 224 224 224 240 240 240 240 240 240 006 007 023
022 024 040 008 040 024 022 240 240 240 240 240 055 055 055 055 055 055 240 240 240 240 240 240 240 240 240 022 024 024 038 039 024 024 024 024 024 040 039 040 022 150 150 150 150 150 150 150 040 039 038 150 150 150 150 150 150 150 150 150 150 150 150 150 150 150 022 024 024 008 008 040 040 024 024 022 008 022 240 240 240 240 240 240 240 240 240 240 240 240 240 240 240 240 240 240 023 022 040 039
024 022 022 038 040 040 022 150 150 150 150 150 150 150 150 150 150 150 150 150 150 150 150 150 150 150 150 022 038 024 022 022 022 022 038 038 024 022 022 040 024 166 166 166 166 166 166 166 022 038 022 040 166 166 166 166 166 166 166 166 166 166 166 166 166 166 039 022 008 038 039 040 038 024 039 024 040 008 022 150 150 150 150 150 150 150 150 150 150 150 150 150 150 150 023 007 022 022 022 038
038 039 039 022 008 022 022 008 008 166 166 166 166 166 166 166 166 166 166 166 166 166 166 166 166 008 008 022 022 024 024 024 022 038 024 022 022 024 024 038 024 022 166 166 166 166 166 040 040 008 039 022 166 166 166 166 166 166 166 166 166 166 166 166 166 008 008 038 008 008 008 008 008 022 039 024 038 008 022 166 166 166 166 166 166 166 166 166 166 166 166 166 166 024 022 022 022 039 022 022
039 022 039 039 038 040 008 022 008 008 022 166 166 166 166 166 166 166 166 166 166 166 166 008 008 008 008 024 024 038 024 039 024 039 022 022 039 022 022 022 022 022 022 166 166 166 008 038 038 022 022 039 022 166 166 166 166 166 166 166 166 166 166 008 008 038 040 039 022 022 022 039 039 008 022 022 039 038 022 166 166 166 166 166 166 166 166 166 166 166 166 166 024 022 024 024 038 022 038 039