144 144 144 144 144 144 144 144 144 144 144 144 144 144 144 144 144 144 144 144 144 144 144 144 144 144 160 160 160 160 160 144 144 144 144 144 144 144 144 144 144 144 144 144 144 144 144 144 144 144 144 144 144 144 144 144 144 144 144 144 144 144 144 144 144 144 144 144 144 144 144 144 144 144 144 144 144 144 144 144 144 144 144 144 144 144 144 144 144 144 144 144 144 144 144 144 144 144 144 144
144 144 144 144 144 144 144 144 144 160 160 160 160 144 144 006 144 144 144 112 160 160 160 160 160 176 176 176 176 176 176 160 160 160 160 160 160 160 160 176 160 160 160 160 144 144 160 160 160 144 048 144 144 144 144 144 144 144 144 144 144 144 144 144 144 058 144 144 144 144 144 144 144 144 144 144 144 144 144 160 144 144 144 144 144 144 144 144 144 144 144 144 160 160 144 144 144 144 144 144
144 144 144 144 144 144 160 160 160 176 176 176 055 032 055 009 010 011 055 032 055 176 176 176 176 176 032 176 176 176 176 176 007 176 176 176 176 176 176 176 176 176 176 003 160 160 056 176 176 160 064 144 144 144 160 160 160 144 144 144 144 144 144 055 055 055 033 055 144 160 144 144 144 144 144 160 160 160 160 176 032 055 032 160 144 144 144 144 144 160 160 160 176 033 055 160 144 144 056 007
160 160 160 160 160 160 176 176 176 176 176 176 176 176 176 176 176 176 176 176 176 176 176 176 032 055 033 032 176 176 176 055 032 055 176 176 176 033 055 032 009 010 011 016 000 000 000 000 000 065 080 160 160 160 176 176 176 160 160 160 144 144 144 144 032 055 032 144 160 176 055 055 112 160 004 176 176 176 176 176 176 033 055 055 160 160 160 007 160 176 176 176 055 032 176 176 160 160 000 000
176 176 176 176 176 176 005 192 055 176 176 176 176 176 176 176 176 176 176 176 176 176 176 176 176 176 176 033 176 176 176 176 176 033 176 176 176 066 067 068 176 176 176 016 210 210 210 210 210 000 000 000 176 176 176 176 176 176 176 176 160 160 160 160 160 160 160 160 176 176 176 033 055 009 010 011 033 055 176 176 176 176 176 176 176 176 055 033 055 176 176 176 176 176 176 176 176 000 196 196
176 176 176 176 192 112 055 055 055 192 192 192 192 192 192 192 176 176 176 176 176 176 176 176 176 176 176 176 176 176 176 176 176 176 176 176 176 082 083 084 176 192 192 210 210 210 210 210 210 210 210 210 002 176 176 176 176 176 176 176 176 176 176 176 176 176 176 176 176 176 176 176 176 176 176 176 176 176 176 176 176 176 176 176 176 176 176 176 176 176 176 176 176 176 176 176 176 196 196 196
192 192 192 192 208 055 055 208 208 208 208 055 055 033 208 208 192 192 192 192 192 006 192 192 192 192 176 176 176 176 176 192 192 192 192 192 192 192 099 192 192 208 016 210 016 016 016 210 210 210 210 210 000 176 176 176 176 176 176 176 176 176 176 176 176 176 176 176 176 176 176 176 176 176 176 176 176 176 176 176 176 176 176 176 176 176 176 176 176 176 176 176 176 176 176 176 000 196 032 196
208 208 208 208 208 208 208 208 208 208 208 208 032 033 033 208 208 208 208 055 032 033 055 208 208 208 192 192 192 192 192 208 208 208 208 066 067 068 115 208 208 208 210 033 210 016 001 016 032 016 210 210 210 176 176 176 176 176 176 176 176 176 176 176 176 176 176 176 066 067 068 192 192 192 192 192 192 192 176 176 176 176 176 176 176 176 176 176 176 176 112 176 176 176 055 000 196 033 016 196
208 208 208 208 208 208 208 208 208 208 208 208 208 208 208 208 208 208 208 055 208 208 208 208 208 208 032 033 055 112 208 208 208 208 208 082 083 084 115 208 208 016 210 210 210 033 016 016 210 016 016 210 210 192 192 192 192 192 176 176 176 176 176 192 192 192 192 192 082 083 084 208 208 192 208 208 208 208 192 176 176 176 176 176 176 001 176 176 176 055 032 055 176 048 176 196 196 033 017 196
224 224 208 208 208 224 224 224 224 208 208 208 208 208 208 208 208 208 208 208 208 208 208 208 208 208 208 208 208 055 208 208 208 208 208 208 099 208 131 208 016 210 016 210 210 016 210 016 210 210 016 210 210 065 208 208 208 208 192 192 192 192 192 208 208 208 208 208 208 099 208 208 208 208 208 208 208 208 208 192 192 192 192 192 055 033 055 176 176 176 176 192 192 064 000 016 196 016 033 032
240 240 224 224 224 240 240 240 240 224 224 224 224 224 224 224 224 224 224 208 208 208 208 208 208 208 208 208 208 208 208 208 208 208 208 208 115 208 115 208 210 016 033 210 016 210 210 210 016 210 033 016 210 000 208 208 208 208 208 208 208 208 208 208 208 208 208 208 208 115 208 208 208 208 208 208 208 208 208 208 208 208 208 055 032 192 192 192 192 192 192 208 208 080 032 032 196 016 033 196
004 240 240 240 240 240 240 240 240 240 240 240 240 240 240 240 240 240 240 224 224 224 224 224 224 224 208 208 208 208 208 208 055 224 056 002 130 224 130 224 210 033 210 210 016 016 210 210 210 210 033 210 210 210 208 208 208 208 208 208 208 208 208 208 208 208 065 056 208 131 208 208 208 208 208 208 208 208 112 055 208 208 208 208 208 208 208 208 208 208 208 208 000 000 196 016 196 196 196 033
000 000 000 000 000 049 240 240 240 240 240 240 240 007 240 240 240 240 001 240 240 240 240 240 240 240 224 224 224 224 224 224 000 000 000 000 000 000 000 000 210 210 016 210 210 016 016 210 032 210 016 016 016 210 208 208 208 055 208 208 208 055 208 208 005 000 000 000 196 196 196 196 208 003 208 208 208 055 055 032 208 208 208 208 208 208 208 208 208 208 208 208 196 033 196 196 196 196 016 033
016 016 016 016 016 000 000 000 000 240 240 240 240 032 240 240 240 033 055 032 240 240 240 240 055 033 240 240 000 000 000 000 016 016 210 210 016 210 016 016 210 210 033 016 032 210 016 016 032 016 210 210 033 210 148 148 148 055 148 148 148 055 148 148 000 016 032 016 016 016 196 000 000 000 148 148 148 148 148 148 148 148 148 148 148 148 148 148 148 148 148 000 196 032 033 033 032 032 196 016
196 196 196 196 016 016 016 016 016 148 148 148 148 055 148 148 148 055 032 055 148 148 148 148 033 055 148 148 016 016 210 210 016 016 016 016 016 016 017 016 210 016 016 210 032 032 210 016 032 016 016 210 033 210 164 164 164 164 164 164 164 164 164 164 016 016 016 016 032 016 033 016 196 196 176 176 176 176 176 176 176 176 176 176 176 176 176 176 176 176 176 196 196 016 016 033 033 196 016 032
