144 144 144 144 144 144 144 144 144 144 144 144 144 144 144 144 144 144 144 144 144 144 144 144 144 144 160 160 160 160 160 144 144 144 144 144 144 144 144 144 144 144 144 144 144 144 144 144 144 144 144 144 144 144 144 144 144 144 144 144 144 144 144 144 144 144 144 144 144 144 144 144 144 144 144 144 144 144 144 144 144 144 144 144 144 144 144 144 144 144 144 144 144 144 144 144 144 144 144 144
144 144 144 144 144 144 144 144 144 160 160 160 160 144 144 144 144 144 144 112 160 160 160 160 160 176 176 176 176 176 176 160 160 160 160 160 160 160 160 176 160 160 160 160 144 144 160 160 160 144 048 144 144 144 144 144 144 144 144 144 144 144 144 144 144 058 144 144 144 144 144 144 144 144 144 144 144 144 144 160 144 144 144 144 144 144 144 144 144 144 144 144 160 160 144 144 144 144 144 144
144 144 144 144 144 144 160 160 160 176 176 176 055 032 055 009 010 011 055 032 055 176 176 176 176 176 032 176 176 176 176 176 176 176 176 176 176 176 176 176 176 176 176 176 160 160 056 176 176 160 064 144 144 144 160 160 160 144 144 144 144 144 144 055 055 055 033 055 144 160 144 144 144 144 144 160 160 160 160 176 032 055 032 160 144 144 144 144 144 160 160 160 176 033 055 160 144 144 056 144
160 160 160 160 160 160 176 176 176 176 176 176 176 176 176 176 176 176 176 176 176 176 176 176 032 055 033 032 176 176 176 055 032 055 176 176 176 033 055 032 009 010 011 016 000 000 000 000 000 065 080 160 160 160 176 176 176 160 160 160 144 144 144 144 032 055 032 144 160 176 176 055 112 160 160 176 176 176 176 176 176 033 055 176 160 160 160 160 160 176 176 176 055 032 176 176 160 160 000 000
176 176 176 176 176 176 176 192 055 176 176 176 176 176 176 176 176 176 176 176 176 176 176 176 176 176 176 033 176 176 176 176 176 033 176 176 176 066 067 068 176 176 176 016 017 017 017 017 017 000 000 000 176 176 176 176 176 176 176 176 160 160 160 160 160 160 160 160 176 176 176 033 055 009 010 011 033 176 176 176 176 176 176 176 176 176 055 033 176 176 176 176 176 176 176 176 176 000 017 001
176 176 176 176 192 112 055 055 055 192 192 192 192 192 192 192 176 176 176 176 176 176 176 176 176 176 176 176 176 176 176 176 176 176 176 176 176 082 083 084 176 192 192 017 017 001 001 001 001 001 001 001 176 176 176 176 176 176 176 176 176 176 176 176 176 176 176 176 176 176 176 176 176 176 176 176 176 176 176 176 176 176 176 176 176 176 176 176 176 176 176 176 176 176 176 176 176 001 001 017
192 192 192 192 208 055 055 208 208 208 208 055 055 033 208 208 192 192 192 192 192 192 192 192 192 192 176 176 176 176 176 192 192 192 192 192 192 192 099 192 192 208 016 017 016 016 016 001 001 001 001 001 000 176 176 176 176 176 176 176 176 176 176 176 176 176 176 176 176 176 176 176 176 176 176 176 176 176 176 176 176 176 176 176 176 176 176 176 176 176 176 176 176 176 176 176 000 001 032 001
208 208 208 208 208 208 208 208 208 208 208 208 032 033 033 208 208 208 208 055 032 033 055 208 208 208 192 192 192 192 192 208 208 208 208 066 067 068 115 208 208 208 017 033 017 016 001 016 032 016 001 001 001 176 176 176 176 176 176 176 176 176 176 176 176 176 176 176 192 192 192 192 192 192 192 192 192 192 176 176 176 176 176 176 176 176 176 176 176 176 112 176 176 176 055 000 001 033 016 001
208 208 208 208 208 208 208 208 208 208 208 208 208 208 208 208 208 208 208 055 208 208 208 208 208 208 032 033 055 112 208 208 208 208 208 082 083 084 115 208 208 016 017 017 017 033 016 016 001 016 016 017 001 192 192 192 192 192 176 176 176 176 176 192 192 192 192 192 208 208 208 208 208 208 208 208 208 208 192 176 176 176 176 176 176 176 176 176 176 055 032 055 176 048 176 001 001 033 017 001
224 224 208 208 208 224 224 224 224 208 208 208 208 208 208 208 208 208 208 208 208 208 208 208 208 208 208 208 208 055 208 208 208 208 208 208 099 208 131 208 016 017 016 017 017 016 017 016 001 001 016 017 001 065 208 208 208 208 192 192 192 192 192 208 208 208 208 208 208 048 208 208 208 208 208 208 208 208 208 192 192 192 192 192 055 033 055 176 176 176 176 192 192 064 000 016 001 016 033 032
240 240 224 224 224 240 240 240 240 224 224 224 224 224 224 224 224 224 224 208 208 208 208 208 208 208 208 208 208 208 208 208 208 208 208 208 115 208 115 208 001 016 033 017 016 017 017 001 016 001 033 016 001 000 208 208 208 208 208 208 208 208 208 208 208 208 208 208 208 064 208 208 208 208 208 208 208 208 208 208 208 208 208 055 032 192 192 192 192 192 192 208 208 080 032 032 017 016 033 001
240 240 240 240 240 240 240 240 240 240 240 240 240 240 240 240 240 240 240 224 224 224 224 224 224 224 208 208 208 208 208 208 055 224 056 224 130 224 130 224 001 033 017 017 016 016 001 001 001 001 033 017 001 001 208 208 208 208 208 208 208 208 208 208 208 208 065 056 208 080 208 208 208 208 208 208 208 208 112 055 208 208 208 208 208 208 208 208 208 208 208 208 000 000 001 016 017 001 001 033
000 000 000 000 000 049 240 240 240 240 240 240 240 240 240 240 240 240 240 240 240 240 240 240 240 240 224 224 224 224 224 224 000 000 000 000 000 000 000 000 001 017 016 001 001 016 016 017 032 001 016 016 016 001 208 208 208 055 208 208 208 055 208 208 208 000 000 000 000 000 000 081 208 208 208 208 208 055 055 032 208 208 208 208 208 208 208 208 208 208 208 208 001 033 017 017 017 017 016 033
016 016 016 016 016 000 000 000 000 240 240 240 240 032 240 240 240 033 055 032 240 240 240 240 055 033 240 240 000 000 000 000 016 016 017 017 016 017 016 016 001 017 033 016 032 001 016 016 032 016 017 017 033 001 148 148 148 055 148 148 148 055 148 148 000 016 032 016 016 016 017 000 000 000 148 148 148 148 148 148 148 148 148 148 148 148 148 148 148 148 148 000 001 032 033 033 032 032 001 016
001 001 001 001 016 016 016 016 016 148 148 148 148 055 148 148 148 055 032 055 148 148 148 148 033 055 148 148 016 016 017 017 016 016 016 016 016 016 017 016 001 016 016 017 032 032 001 016 032 016 016 017 033 001 164 164 164 164 164 164 164 164 164 164 016 016 016 016 032 016 033 016 017 017 176 176 176 176 176 176 176 176 176 176 176 176 176 176 176 176 176 001 001 016 016 033 033 001 016 032
